  ################     
   ######  ######      
  #      ###     #     
 #                #    
# P              P #   
#        B         #   
 #       B        #    
  ##     B      ##     
   #            #      
   #   B        #      
   #            #      
   #            #      
   #      B     #      
   #     BBB    #      
  #        B     #     
  #  P           #     
   #     B       #     
    #   B      P#      
     ###########       